lname	lcode
# Commented lines are not yet available.
#Arabic	ar
#Bengali	bn
	Catalan	ca
Chinese	zh
	Danish	da
	Dutch	nl
	Esperanto	eo
Finnish	fi
	French	fr
	German	de
#Hindi	hi
	Hungarian	hu
	Indonesian	id
	Italian	it
Japanese	ja
	Javanese	jv
Korean	ko
	Malay	ms
	Norwegian	no
	Norwegian Nynorsk	nn
	Polish	pl
	Portuguese	pt
	Russian	ru
	Spanish	es
	Swahili	sw
	Swedish	sv
	Tagalog	tl
Thai	th
	Turkish	tr
Vietnamese	vi
